NO ./path_to_the_north_texture.xpm      
SO ./path_to_the_south_texture.xpm     


 
WE ./path_to_the_west_texture.xpm                    

EA ./path_to_the_east_texture.xpm
F 220,,,,,,,100,0,,,,,,,,,,,,,,,,
C 225,30,0

111111111111111111111111111111
111111000000000000000000000011
111111000000000000000000000011
111110000000011111111111000001
111100000000111111111111100001
111100000000011111111110000001
111100000000000000000000000001
111000000000000N00000000000001
111000000000000000000000000001
111000000111111111111000010001
1100000011          1110010001
110000011            101101011
111111111            111010001
111111111            111111111