NO ./path_to_the_north_texture.xpm      
SO ./path_to_the_south_texture.xpm     


 
WE ./path_to_the_west_texture.xpm                    

EA ./path_to_the_east_texture.xpm
F 128,    ,126,120,,,,,,,,,,,,,,,,
C 25,    ,30,40


11111111111111111111111111111
111000000000000000000000000011
1110100N000000000000000000111
111110000000111111111100000011
11111000000111111111111100001
100000000000011111111110000001
111100000000000000000000000001
1110000000000000000000000000011
11100000000000000111000000000001
1110000001111111111111000010001
1100000011          1110010001
110000011            111101011
11111111             11111111
111111111            111111111
