NO ./wall3.xpm      
SO ./wall2.xpm     


 
WE ./wall1.xpm                    

EA ./wall5.xpm
F 128,    ,126,120,,,,,,,,,,,,,,,,
C 25,    ,30,40


11111111111111111111111111111
111000000000000000000000000011
1110100000000000000000000011
11111000000011111111110000011
1111100W001111111111111000011
100000000000111111111100000011
1111000000000000000000000000011
1110000000000000000000000000011
1110000000000000011100000000001
1110000001111111111111000010001
1100000011          1110010001
110000011            111101011
11111111             11111111
111111111            111111111
