NO ./wall3.xpm      
SO ./wall2.xpm     


 
WE ./wall1.xpm                    

EA ./wall1.xpm
F 128,    ,126,120,,,,,,,,,,,,,,,,
C 25,    ,30,40


11111111111111111111111111111
1110000000S0000000000000000011
11101000000000000000000000111
11111000000011111111110000011
11111000000111111011111100001
10000000000011111111110000001
111100000000000000000000000001
1110000000000000000000000000011
1110000000000000011100000000001
1110000001111111111111000010001
1100000011          1110010001
110000011            111101011
11111111             11111111
111111111            111111111
