C 50, 50, 50
F 100, 100, 100

NO ./wall1.xpm      

SO ./wall3.xpm


WE ./3.xpm                    
EA ./wall4.xpm



1111111111111111111111111111
111000000000000000000000011
11110000000W0000000000000011
111100000011111111110000011
11111000001111111111111000011
110000000000111111111100000011111
11110000000000000000000000000111
 11111111000000000000000000000111111111
         11110000000000000000000000000011
11111111111000000000000000000011111111111
1110000000000000000000000000011
1110000000000000000000000000011
1110000000000000000000000000011
1110000000000000000000000000011
1110000000000000000000000000011
1110000000000000000000000000011
1110000000000000011100000000001
1111111111111111111111000010001
1111111111          1110000001
111111111            111111111
11111111             11111111
111111111            111111111
