NO ./wall3.xpm      
F 126, 155, 130 
C 125, 130, 154


SO ./wall2.xpm


WE ./wall1.xpm                    
EA ./wall5.xpm




1111111111111111111111111111
11100000000000000000000000011
1110100000000000000000000011
10111000000011111111110000011
1111100S001111111111111000011
100000000000111111111100000011
1111000000000000000000000000011
1110000000000000000000000000011
1110000000000000000000000000011
1110000000000000000000000000011
1110000000000000000000000000011
1110000000000000000000000000011
1110000000000000000000000000011
1110000000000000000000000000011
1110000000000000000000000000011
1110000000000000000000000000011
1110000000000000000000000000011
1110000000000000000000000000011
1110000000000000000000000000011
1110000000000000000000000000011
1110000000000000000000000000011
1110000000000000000000000000011
1110000000000000000000000000011
1110000000000000011100000000001
1110000001111111111111000010001
1100000011          1110010001
110000011            111101011
11111111             11111111
111111111            111111111
