NO ./path_to_the_north_texture.xpm      
SO ./path_to_the_south_texture.xpm     



WE ./path_to_the_west_texture.xpm                    

EA ./path_to_the_east_texture.xpm
F 220,,,,,,,100,0,,,,,,,,,,,,,,,,
C 225,30,0

111111111111111111111111111111
111110000000001100000000000011
111110110000011100000000000011
111110010000000000000000000011111
1111111011000001110000000000000001
100000000011000001110111111111111
11110111111111010000000010001
11110111111111011101010010001
11000000110101011100000000001
10000000000000001100000010001
10000000000000001101010010001
11000001110101011101011010N0111
1111011   1101011101111010001
1111111   1111111111111111111